6 
4 14 31 43 55 74 91 

8 8 4
2 2 2 2 2 2 2 2
2 9 1 9 1 1 3 2
2 1 1 1 1 1 1 2
2 1 7 1 2 1 9 2
2 1 1 1 2 1 1 2
2 1 1 1 2 2 1 2
2 1 1 1 1 1 1 2
2 2 2 2 2 2 2 2

15 10 5
2 2 2 2 2 2 2 2 2 2 2 2 2 2 2 
2 9 2 1 1 1 1 2 1 1 1 1 2 1 2 
2 1 2 1 1 1 1 2 1 1 1 1 2 1 2 
2 1 2 1 1 1 1 2 1 1 1 2 2 1 2 
2 1 2 1 1 1 9 1 9 1 1 1 1 1 2 
2 1 1 1 1 1 1 2 1 1 1 2 2 1 2 
2 1 1 1 1 7 1 2 1 1 1 2 1 9 2 
2 1 1 1 1 1 1 2 1 1 1 2 1 1 2 
2 1 1 1 1 1 1 2 1 1 1 2 9 1 2 
2 2 2 2 2 2 2 2 2 2 2 2 2 2 2 

10 15 4
2 2 2 2 2 2 2 2 2 2 
2 1 1 2 1 1 1 1 9 2 
2 9 1 2 1 1 1 1 1 2 
2 1 9 2 1 1 1 1 1 2 
2 1 1 2 1 1 1 1 1 2 
2 1 1 2 1 1 1 1 1 2 
2 1 1 2 2 2 2 2 1 2 
2 1 1 1 1 1 1 1 1 2 
2 1 7 1 1 1 1 1 1 2 
2 1 1 1 1 1 1 1 1 2 
2 1 1 1 2 2 2 2 2 2 
2 1 1 1 2 1 1 1 1 2 
2 1 1 1 1 1 1 1 1 2 
2 1 1 1 1 1 1 1 9 2 
2 2 2 2 2 2 2 2 2 2 

20 20 0
2 2 2 2 2 2 2 2 2 2 2 2 2 2 2 2 2 2 2 2 
2 1 1 1 1 1 1 1 1 1 1 1 1 1 1 1 1 1 1 2 
2 1 1 1 1 1 1 1 1 1 1 1 1 1 1 1 1 1 1 2 
2 1 1 1 1 1 1 1 1 1 1 1 1 1 1 1 1 1 1 2 
2 1 1 1 1 1 1 1 1 1 1 1 1 1 1 1 1 1 1 2 
2 1 1 1 1 1 1 1 1 1 1 1 1 1 1 1 1 1 1 2 
2 1 1 1 1 1 1 1 1 1 1 1 1 1 1 1 1 1 1 2 
2 1 1 1 1 1 1 1 1 1 1 1 1 1 1 1 1 1 1 2 
2 1 1 1 1 1 1 1 1 1 1 1 1 1 1 1 1 1 1 2 
2 1 1 1 1 1 1 1 1 1 1 1 1 1 1 1 1 1 1 2 
2 1 1 1 1 1 1 1 1 1 1 1 1 1 1 1 1 1 1 2 
2 1 1 1 1 1 1 1 1 1 1 1 1 1 1 1 1 1 1 2 
2 1 1 1 1 1 1 1 1 1 1 1 1 1 1 1 1 1 1 2 
2 1 1 1 1 1 1 1 1 1 1 1 1 1 1 1 1 1 1 2 
2 1 1 1 1 1 1 1 1 1 1 1 1 1 1 1 1 1 1 2 
2 1 1 1 1 1 1 1 1 1 1 1 1 1 1 1 1 1 1 2 
2 1 1 1 1 1 1 1 1 1 1 1 1 1 1 1 1 1 1 2 
2 1 1 1 1 1 1 1 1 1 1 1 1 1 1 1 1 1 1 2 
2 1 1 1 1 1 1 1 1 1 1 1 1 1 1 1 1 1 1 2 
2 2 2 2 2 2 2 2 2 2 2 2 2 2 2 2 2 2 2 2 

17 13 0
2 2 2 2 2 2 2 2 2 2 2 2 2 2 2 2 2 
2 1 1 1 1 1 1 1 1 1 1 1 1 1 1 1 2 
2 1 1 1 1 1 1 1 1 1 1 1 1 1 1 1 2 
2 1 1 1 1 1 1 1 1 1 1 1 1 1 1 1 2 
2 1 1 1 1 1 1 1 1 1 1 1 1 1 1 1 2 
2 1 1 1 1 1 1 1 1 1 1 1 1 1 1 1 2 
2 1 1 1 1 1 1 1 1 1 1 1 1 1 1 1 2 
2 1 1 1 1 1 1 1 1 1 1 1 1 1 1 1 2 
2 1 1 1 1 1 1 1 1 1 1 1 1 1 1 1 2 
2 1 1 1 1 1 1 1 1 1 1 1 1 1 1 1 2 
2 1 1 1 1 1 1 1 1 1 1 1 1 1 1 1 2 
2 1 1 1 1 1 1 1 1 1 1 1 1 1 1 1 2 
2 2 2 2 2 2 2 2 2 2 2 2 2 2 2 2 2 

15 10 0
2 2 2 2 2 2 2 2 2 2 2 2 2 2 2 
2 1 1 1 1 1 1 1 1 1 1 1 1 1 2 
2 1 1 1 1 1 1 1 1 1 1 1 1 1 2 
2 1 1 1 1 1 1 1 1 1 1 1 1 1 2 
2 1 1 1 1 1 1 1 1 1 1 1 1 1 2 
2 1 1 1 1 1 1 1 1 1 1 1 1 1 2 
2 1 1 1 1 1 1 1 1 1 1 1 1 1 2 
2 1 1 1 1 1 1 1 1 1 1 1 1 1 2 
2 1 1 1 1 1 1 1 1 1 1 1 1 1 2 
2 2 2 2 2 2 2 2 2 2 2 2 2 2 2
